Gente - People
Humanidad - Humanity
Humano - Human
Persona - Person
Hombre - Man
Mujer - Woman
Bebé - Baby
Niño - Child
Niña - Child
Adolescente - Teenager
Adulto, Adulta - Adult
Anciano - Elderly Person
Anciana - Elderly Person
Don - Mr
Doña - Mrs
Señor - Sir
Señora - Madam
Caballero - Gentleman
Dama - Lady
Individuo - Individual
Cuerpo - Body
Pierna - Leg
Pie - Foot
Talón - Heel
Espinilla - Shin
Rodilla - Knee
Muslo - Thigh
Cabeza - Head
Cara - Face
Boca - Mouth
Labio - Lip
Diente - Tooth
Ojo - Eye
Nariz - Nose
Barba - Beard
Bigote - Mustache
Cabello - Hair
Oreja - Ear
Cerebro - Brain
Estómago - Stomach
Brazo - Arm
Codo - Elbow
Hombro - Shoulder
Uña - Nail
Mano - Hand
Muñeca - Wrist
Palma - Palm
Dedo - Finger
Trasero - Buttocks
Culo - Buttocks
Cola - Buttocks
Glúteos - Buttocks
Abdomen - Abdomen
Hígado - Liver
Músculo - Muscle
Cuello - Neck
Corazón - Heart
Mente - Mind
Alma - Soul
Espíritu - Spirit
Pecho - Chest
Cintura - Waist
Cadera - Hip
Espalda - Back
Sangre - Blood
Carne - Flesh
Piel - Skin
Hueso - Bone
Resfriado - Cold
Gripe - Flu
Diarrea - Diarrhea
Salud - Health
Enfermedad - Illness
Familia - Family
Amigo - Friend
Amiga - Friend
Conocido - Acquaintance
Conocida - Acquaintance
Colega - Colleague
Pareja - Partner
Esposo - Husband
Esposa - Wife
Matrimonio - Marriage
Amor - Love
Padre - Father
Madre - Mother
Hermano - Brother
Hermana - Sister
Hijo - Son 
Hija - Daughter
Abuelo - Grandfather
Abuela - Grandmother
Bisabuelo - Great grandfather
Bisabuela - Great grandmother
Nieto - Grandson
Nieta - Granddaughter
Bisnieto - Great grandson
Bisnieta - Great granddaughter
Primo - Cousin
Prima - Cousin
Tío - Uncle
Tía - Aunt
Sobrino - Nephew
Sobrina - Niece
Criatura - Creature
Especie - Species
Ser - Being
Vida - Life
Nacimiento - Birth
Reproducción - Reproduction
Muerte - Death
Naturaleza - Nature
Campo - Countryside
Bosque - Forest
Selva - Jungle
Jungla - Jungle
Desierto - Desert
Costa - Coast
Playa - Beach
Río - River
Laguna - Lagoon
Lago - Lake
Mar - Sea 
Océano - Ocean
Cerro - Hill
Monte - Hill
Montaña - Mountain
Luz - Light
Energía - Energy
Animal - Animal
Perro - Dog
Gato - Cat
Vaca - Cow
Cerdo - Pig
Caballo - Horse 
Yegua - Mare
Oveja - Sheep
Mono - Monkey
Ratón - Mouse
Rata - Rat
Tigre - Tiger
Conejo - Rabbit
Dragón - Dragon
Ciervo - Deer
Rana - Frog
León - Lion
Jirafa - Giraffe
Elefante - Elephant
Pájaro - Bird
Gallina - Hen
Gorrion - Sparrow
Cuervo - Crow
Águila - Eagle
Halcón - Hawk
Pez - Fish
Camarón - Shrimp
Langosta - Lobster
Sardina - Sardine
Atún - Tuna
Calamar - Squid
Pulpo - Octopus
Insecto - Insect
Bicho - Bug
Mariposa - Butterfly
Polilla - Moth
Saltamontes - Grasshopper
Araña - Spider
Mosca - Fly
Mosquito - Mosquito
Cucaracha - Cockroach
Caracol - Snail
Babosa - Slug
Lombriz - Worm
Marisco - Shellfish
Molusco - Mollusk
Lagarto - Lizard
Serpiente - Snake
Cocodrilo - Crocodile
Alimento - Food
Comida - Meal
Bebida - Drink
Vegetal - Vegetable
Planta - Plant
Pasto - Grass
Césped - Grass
Flor - Flower
Fruta - Fruit
Semilla - Seed
Árbol - Tree
Hoja - Leaf
Raíz - Root
Tallo - Stem
Hongo - Fungus
Ciruela - Plum
Pino - Pine
Bambú - Bamboo
Nuez - Nut
Almendra - Almond
Castaña - Chestnut
Arroz - Rice
Avena - Oat
Cebada - Barley
Trigo - Wheat
Verdura - Vegetable
Patatas - Potatoes
Papas - Potatoes
Judías - Beans
Guisantes - Beans
Porotos - Peas
Rábano - Radish
Zanahoria - Carrot
Manzana - Apple
Naranja - Orange
Plátano - Banana
Pera - Pear
Castaño - Chestnut
Durazno - Peach
Tomate - Tomato
Sandía - Watermelon
Carne - Meat
Gaseosa - Soda
Tiempo - Time
Calendario - Calendar
Edad - Age
Época - Era
Era - Era
Fecha - Date
Instante - Instant
Momento - Moment
Segundo - Second
Minuto - Minute
Hora - Hour
Día - Day
Semana - Week
Entre semana - Weekday
Fin de semana - Weekend
Mes - Month
Año - Year
Década - Decade
Siglo - Century
Milenio - Millennium
Ayer - Yesterday
Hoy - Today
Mañana - Tomorrow
Amanecer - Dawn
Mediodía - Noon
Tarde - Afternoon
Anochecer - Dusk
Noche - Night
Lunes - Monday
Martes - Tuesday
Miércoles - Wednesday
Jueves - Thursday
Viernes - Friday
Sábado - Saturday
Domingo - Sunday
Ambiente - Environment
Espacio - Space
Entorno - Surroundings
Área - Area
Superficie - Surface
Volumen - Volume
Región - Region
Zona - Zone
Lado - Side
Mundo - World
Planeta - Planet
Sol - Sun
Luna - Moon
Estrella - Star
Galaxia - Galaxy
Universo - Universe
Clima - Climate
Despejado - Clear
Nublado - Cloudy
Lluvia - Rain
Nieve - Snow
Viento - Wind
Trueno - Thunder
Rayo - Lightning
Tormenta - Storm
Cielo - Sky
Este - East
Oeste - West
Sur - South
Norte - North
Derecha - Right
Izquierda - Left
Diagonal - Diagonal
Exterior - Exterior
Interior - Interior
Calor - Heat
Agua - Water
Hielo - Ice
Vapor - Steam
Fuego - Fire
Gas - Gas
Aire - Air
Atmósfera - Atmosphere
Tierra - Earth
Piso - Floor
Suelo - Soil
Metal - Metal
Metálico - Metallic
Hierro - Iron
Oro - Gold
Plata - Silver
Plomo - Lead
Sal - Salt
Barro - Mud
Lodo - Mud
Peso - Weight
Metro - Meter
Milímetro - Millimeter
Centímetro - Centimeter
Kilómetro - Kilometer
Litro - Liter
Gramo - Gram
Kilo - Kilogram
Cantidad - Quantity
Total - Total
Medida - Measurement
Sociedad - Society
Comunidad - Community
Reunión - Meeting
Encuentro - Encounter
Estructura - Structure
Administración - Administration
Organización - Organization
Asociación - Association
Empresa - Company
Equipo - Team
Autoridad - Authority
Cargo - Position
Campaña - Campaign
Club - Club
Comisión - Commission
Congreso - Congress
Consejo - Council
Partido - Party
País - Country
Nación - Nation
Gobierno - Government
Estado - State
Provincia - Province
Departamento - Department
Municipio - Municipality
Democracia - Democracy
Dictadura - Dictatorship
Política - Politics
Político - Politician
Presidente - President
Ministro - Minister
Director - Director
Parlamentario - Parliamentarian
Congresista - Congressman
Senador -  Senator
Diputado -  Deputy
Representante - Representative
Gobernador - Governor
Intendente -Mayor
Alcalde - Mayor
Policía - Police
Bomberos - Firefighters
Capital - Capital
Ciudad - City
Población - Population
Pueblo - Town
Villa - Village
Obligación - Obligation
Libertad - Freedom
Derecho - Right
Permiso - Permission
Prohibición - Prohibition
Constitución - Constitution
Ley - Law
Decreto - Decree
Norma - Norm
Economía - Economy
Consumo - Consumption
Demanda - Demand
Compañía - Company
Comercio - Commerce
Mercado - Market
Servicio - Service
Producto - Product
Producción - Production
Transacción - Transaction
Almacén - Warehouse
Hotel - Hotel
Fábrica - Factory
Cuenta - Account
Boleto - Ticket
Entrada - Entrance
Dinero - Money
Billete - Bill
Vuelto - Change
Cambio - Change
Máquina expendedora - Vending machine
Precio - Price
Tarifa -Fare
Valor - Value
Escritorio - Desk
Silla - Chair
Mesa - Table
Cama - Bed
Dormitorio - Bedroom
Habitación - Room
Cuarto - Room
Oficina - Office
Panel - Panel
Puerta - Door
Ventana - Window
Entrada - Entrance
Hogar - Home
Casa - House
Residencia - Residence
Apartamento - Apartment
Edificio - Building
Piso - Floor
Techo - Ceiling
Pared - Wall
Suelo - Floor
Alfombra - Carpet
Cortina - Curtain
Persiana - Blind
Lámpara - Lamp
Luz - Light
Bombilla - Bulb
Enchufe - Plug
Interruptor - Switch
Enchufe - Socket
Cable - Cable
Antena - Antenna
Televisión - Television
Radio - Radio
Teléfono - Telephone
Móvil - Mobile phone
Celular - Cell phone
Computadora - Computer
Portátil - Laptop
Tableta - Tablet
Cámara - Camera
Video - Video
Pantalla - Screen
Teclado - Keyboard
Ratón - Mouse
Auriculares - Headphones
Altavoz - Speaker
Micrófono - Microphone
Instrumento - Instrument
Piano - Piano
Guitarra - Guitar
Violín - Violin
Trompeta - Trumpet
Flauta - Flute
Tambor - Drum
Tambor - Drum
Caja - Box
Bolsa - Bag
Maleta - Suitcase
Mochila - Backpack
Vestido - Dress
Camisa - Shirt
Pantalón - Pants
Falda - Skirt
Zapato - Shoe
Sombrero - Hat
Guante - Glove
Bufanda - Scarf
Gafas - Glasses
Reloj - Watch
Joya - Jewel
Anillo - Ring
Collar - Necklace
Pulsera - Bracelet
Broche - Brooch
Maquillaje - Makeup
Lápiz labial - Lipstick
Sombra de ojos - Eyeshadow
Rímel - Mascara
Perfume - Perfume
Jabón - Soap
Champú - Shampoo
Acondicionador - Conditioner
Cepillo - Brush
Peine - Comb
Toalla - Towel
Sábana - Sheet
Manta - Blanket
Almohada - Pillow
Bolsa de dormir - Sleeping bag
Tienda de campaña - Tent
Cocina - Kitchen
Estufa - Stove
Horno - Oven
Refrigerador - Refrigerator
Congelador - Freezer
Fregadero - Sink
Grifo - Faucet
Vaso - Glass
Taza - Cup
Plato - Plate
Tenedor - Fork
Cuchillo - Knife
Cuchara - Spoon
Servilleta - Napkin
Comedor - Dining room
Mesa - Table
Silla - Chair
Servicio - Service
Menú - Menu
Comida - Food
Bebida - Drink
Desayuno - Breakfast
Almuerzo - Lunch
Cena - Dinner
Postre - Dessert
Fruta - Fruit
Verdura - Vegetable
Carne - Meat
Pescado - Fish
Marisco - Seafood
Sopa - Soup
Ensalada - Salad
Salsa - Sauce
Pan - Bread
Arroz - Rice
Pasta - Pasta
Sopa - Soup
Estofado - Stew
Pizza - Pizza
Hamburguesa - Hamburger
Hotdog - Hotdog
Pastel - Cake
Pastelería - Bakery
Helado - Ice cream
Cerveza - Beer
Vino - Wine
Café - Coffee
Té - Tea
Agua - Water
Refresco - Soft drink
Zumo - Juice
Refresco - Soda
Leche - Milk
Queso - Cheese
Yogur - Yogurt
Huevos - Eggs
Mantequilla - Butter
Aceite - Oil
Azúcar - Sugar
Sal - Salt
Pimienta - Pepper
Especias - Spices
Hierbas - Herbs
Condimento - Condiment
Cocina - Cuisine
Cocinero - Chef
Cocinera - Chef
Receta - Recipe
Ingredientes - Ingredients
Preparación - Preparation
Cocina - Cooking
Asar - Roast
Cocinar - Cook
Freír - Fry
Hornear - Bake
Hervir - Boil
Picar - Chop
Mezclar - Mix
Batir - Beat
Servir - Serve
Comer - Eat
Beber - Drink
Probar - Taste
Degustar - Savor
Restaurante - Restaurant
Café - Cafe
Bar - Bar
Mesero - Waiter
Mesera - Waitress
Cliente - Customer
Menú - Menu
Pedido - Order
Plato principal - Main course
Entrada - Appetizer
Postre - Dessert
Factura - Bill
Propina - Tip
Cocina internacional - International cuisine
Comida rápida - Fast food
Comida casera - Home cooked meal
Comida saludable - Healthy food
Comida vegetariana - Vegetarian food
Comida vegana - Vegan food
Comida sin gluten - Gluten free food
Comida picante - Spicy food
Comida dulce - Sweet food
Comida salada - Savory food
Comida gourmet - Gourmet food
Comida exótica - Exotic food
Comida tradicional - Traditional food
Comida callejera - Street food
Comida congelada - Frozen food
Comida enlatada - Canned food
Comida a la parrilla - Grilled food
Comida para llevar - Takeout food
Comida para niños - Kid-friendly food
Comida para adultos - Adult food
Comida para mayores - Senior food
Comida para mascotas - Pet food
Aves - Birds
Animales domésticos - Pets
Mascota - Pet
Perro - Dog
Gato - Cat
Pez - Fish
Pájaro - Bird
Conejo - Rabbit
Hámster - Hamster
Cuy - Guinea pig
Cobaya - Guinea pig
Hurón - Ferret
Ratón - Mouse
Rata - Rat
Serpiente - Snake
Lagarto - Lizard
Tortuga - Turtle
Rana - Frog
Insectos - Insects
Hormiga - Ant
Abeja - Bee
Mariposa - Butterfly
Mosca - Fly
Mosquito - Mosquito
Araña - Spider
Cucaracha - Cockroach
Hola - Hello
Profesor - Teacher
Profesora - Teacher
Estudiante - Student
Alumno - Student
Alumna - Student
Escuela - School
Colegio - High school
Universidad - University
Biblioteca - Library
Libro - Book
Cuaderno - Notebook
Lápiz - Pencil
Bolígrafo - Pen
Tiza - Chalk
Pizarra - Blackboard
Clase - Class
Lección - Lesson
Examen - Exam
Prueba - Test
Calificación - Grade
Nota - Grade
Matrícula - Enrollment
Graduación - Graduation
Diploma - Diploma
Certificado - Certificate
Título - Degree
Carrera - Career
Trabajo - Job
Profesión - Profession
Oficio - Trade
Empleado - Employee
Empleada - Employee
Jefe - Boss
Jefa - Boss
Compañero - Colleague
Compañera - Colleague
Salario - Salary
Sueldo - Wage
Horas extras - Overtime
Vacaciones - Vacation
Feriado - Holiday
Contrato - Contract
Desempleo - Unemployment
Currículum - Resume
Entrevista - Interview
Carta de presentación - Cover letter
Experiencia - Experience
Habilidad - Skill
Capacitación - Training
Promoción - Promotion
Ascenso - Promotion
Evaluación - Evaluation
Desempeño - Performance
Beneficio - Benefit
Seguro - Insurance
Jubilación - Retirement
Pensión - Pension
Reunión - Meeting
Conferencia - Conference
Seminario - Seminar
Taller - Workshop
Convención - Convention
Simposio - Symposium
Congreso - Congress
Charla - Talk
Debate - Debate
Discusión - Discussion
Proyecto - Project
Tarea - Task
Objetivo - Objective
Meta - Goal
Plan - Plan
Estrategia - Strategy
Informe - Report
Memorándum - Memorandum
Acta - Minutes
Agenda - Agenda
Horario - Schedule
Calendario - Calendar
Fecha límite - Deadline
Entrega - Delivery
Desarrollo - Development
Progreso - Progress
Resultado - Result
Éxito - Success
Fracaso - Failure
Problema - Problem
Solución - Solution
Desafío - Challenge
Reto - Challenge
Oportunidad - Opportunity
Idea - Idea
Creatividad - Creativity
Innovación - Innovation
Cambio - Change
Transformación - Transformation
Mejora - Improvement
Evaluación - Assessment
Retroalimentación - Feedback
Crítica - Criticism
Elogio - Praise
Reconocimiento - Recognition
Logro - Achievement
Ética - Ethics
Moral - Morals
Integridad - Integrity
Honestidad - Honesty
Responsabilidad - Responsibility
Compromiso - Commitment
Dedicación - Dedication
Lealtad - Loyalty
Trabajo en equipo - Teamwork
Colaboración - Collaboration
Comunicación - Communication
Motivación - Motivation
Liderazgo - Leadership
Visión - Vision
Misión - Mission
Valores - Values
Cultura - Culture
Identidad - Identity
Marca - Brand
Publicidad - Advertising
Marketing - Marketing
Mercadeo - Marketing
Cliente - Customer
Consumidor - Consumer
Venta - Sale
Compra - Purchase
Negociación - Negotiation
Contrato - Contract
Acuerdo - Agreement
Convenio - Agreement
Socio - Partner
Asociado - Associate
Proveedor - Supplier
Distribuidor - Distributor
Mayorista - Wholesaler
Minorista - Retailer
Cliente potencial - Prospect
Investigación - Research
Estudio - Study
Encuesta - Survey
Análisis - Analysis
Informe - Report
Datos - Data
Estadísticas - Statistics
Gráfico - Graph
Tabla - Table
Diagrama - Diagram
Mapa - Map
Plano - Plan
Proyecto - Project
Planificación - Planning
Organización - Organization
Ejecución - Execution
Seguimiento - Monitoring
Control - Control
Evaluación - Evaluation
Auditoría - Audit
Riesgo - Risk
Seguridad - Security
Cumplimiento - Compliance
Normativa - Regulation
Política - Policy
Procedimiento - Procedure
Proceso - Process
Manual - Manual
Guía - Guide
Instrucción - Instruction
Directiva - Directive
Protocolo - Protocol
Norma - Standard
Criterio - Criterion
Parámetro - Parameter
Requisito - Requirement
Especificación - Specification
Condición - Condition
Restricción - Restriction
Permiso - Permission
Autorización - Authorization
Licencia - License
Certificación - Certification
Calidad - Quality
Eficiencia - Efficiency
Eficacia - Effectiveness
Productividad - Productivity
Desempeño - Performance
Rendimiento - Yield
Beneficio - Profit
Ganancia - Profit
Ingresos - Revenue
Gastos - Expenses
Costos - Costs
Presupuesto - Budget
Inversión - Investment
Financiamiento - Financing
Crédito - Credit
Préstamo - Loan
Deuda - Debt
Capital - Capital
Acciones - Shares
Bonos - Bonds
Dividendo - Dividend
Interés - Interest
Rentabilidad - Profitability
Liquidez - Liquidity
Solvencia - Solvency
Activos - Assets
Pasivos - Liabilities
Patrimonio - Equity
Balance - Balance
Estado de resultados - Income statement
Estado de flujo de efectivo - Cash flow statement
Contabilidad - Accounting
Auditoría - Auditing
Impuestos - Taxes
Tributos - Taxes
Declaración - Declaration
Declaración de impuestos - Tax return
Factura - Invoice
Recibo - Receipt
Pago - Payment
Cobro - Collection
Transferencia - Transfer
Depósito - Deposit
Retiro - Withdrawal
Cheque - Check
Tarjeta de crédito - Credit card
Tarjeta de débito - Debit card
Moneda - Currency
Dólar - Dollar
Euro - Euro
Yen - Yen
Libra - Pound
Bolsa de valores - Stock exchange
Mercado bursátil - Stock market
Índice - Index
Cotización - Quotation
Acciones - Shares
Bonos - Bonds
Derivados - Derivatives
Opciones - Options
Futuros - Futures
Fondos de inversión - Investment funds
Fondos de pensiones - Pension funds
Ahorro - Savings
Inversión - Investment
Plan de pensiones - Pension plan
Plan de jubilación - Retirement plan
Seguro de vida - Life insurance
Seguro de salud - Health insurance
Seguro de automóvil - Car insurance
Seguro de hogar - Home insurance
Prima - Premium
Cobertura - Coverage
Indemnización - Compensation
Reclamación - Claim
Agente de seguros - Insurance agent
Corredor de seguros - Insurance broker
Política - Policy
Aeropuerto - Airport
Amarillo - Yellow
Aprender - Learn
Arco - Arch
Ardilla - Squirrel
Azul - Blue
Barco - Ship
Barro - Clay
Basura - Trash
Blanco - White
Borrar - Erase
Café - Brown
Caliente - Hot
Calmar - Calm
Cantar - Sing
Cebra - Zebra
Cepillo - Brush
Cerradura - Lock
Cerrar - Close
Cielo - Sky
Cine - Cinema
Círculo - Circle
Claro - Clear
Colina - Hill
Comedor - Dining room
Conejo - Rabbit
Corazón - Heart
Corrección - Correction
Cortar - Cut
Cuadro - Frame
Cubo - Cube
Cuchara - Spoon
Curva - Curve
Descanso - Rest
Desierto - Desert
Dormir - Sleep
Ducha - Shower
Durazno - Peach
Edificio - Building
Ejemplo - Example
Electricidad - Electricity
Elegir - Choose
Escribir - Write
Escuchar - Listen
Espacio - Space
Espejo - Mirror
Estación - Station
Flor - Flower
Fuerte - Strong
Fuego - Fire
Fuente - Fountain
Girar - Turn
Golpear - Hit
Gris - Gray
Guardar - Save
Hacer - Do
Hierba - Grass
Idioma - Language
Juego - Play
Juguete - Toy
Largo - Long
Lección - Lesson
León - Lion
Lento - Slow
Llave - Key
Llover - Rain
Luz - Light
Maleta - Suitcase
Mapa - Map
Marrón - Brown
Mesa - Desk
Montaña - Hill
Mover - Move
Musgo - Moss
Negro - Black
Nube - Cloud
Número - Number
Océano - Ocean
Ola - Wave
Ordenador - Computer
Oso - Bear
Paloma - Dove
Paraguas - Umbrella
Pato - Duck
Pequeño - Small
Perro - Dog
Planta - Plant
Pluma - Feather
Rana - Frog
Ratón - Mouse
Rectángulo - Rectangle
Reloj - Watch
Resplandor - Glow
Rosa - Pink
Rubio - Blond
Sal - Salt
Saltar - Jump
Sombra - Shade
Sonrisa - Smile
Suave - Soft
Sueño - Dream
Tigre - Tiger
Tocar - Touch
Torre - Tower
Trabajar - Work
Vaca - Cow
Ventana - Window
Verde - Green
Viajar - Travel
